1111111111111
100100P0000C1
1111110101111
100000E100001
1111111111111