1111111111111
10010CP0000C1
1111110101111
100C00E1CCC01
1111111111111