1111111111111111111111111111111111
101000000000000C11PE0C001000000001
1C1001010M10000110100100100M010101
1011110010101010001001000000010101
100000000C00C0000000000011100000C1
1111111111111111111111111111111111