1111111111111111111111111111111111
1E1000000000000011P00C001000000001
1C1001010M10000110100100100M010101
1011110010101010001001000000010101
100000000C00C000000000001110000001
1111111111111111111111111111111111