111111
1ECP11
111111
111111
111111
111111
111111